NO                                                         ./textures/wall_no.png



SO                  ./textures/wall_so.png
EA ./textures/wall_ea.png
WE                  ./textures/wall_we.png
F 254,45,60
C 225,30,5



111111111
111111111
111111111
100000001
1000S0001
110111011
1111111111
