1111111111111
1C010000000C1

1P00110010101
100011E000C01
1111111111111
