1111111111111
1C010000000C1
1000011111001
1P00110010001
1000110000C01
1111111111111
