NO ./textures/wall_no.png
SO ./textures/wall_so.png
EA ./textures/wall_ea.png
WE ./textures/wall_we.png
F 254,45,60
C 225,30,5

  0
111111111
100000001
110000011
100N00011
110000011
100000001
111111111
