1111111111111
1C010000000E1
1000011111001
1P00110020001
1000110000C01
1111111111111
