1111111111111
1C010000001C1
1000011110111
1P00110010001
100011E000C01
1111111111111
