1111111111
1011111001
1P0C0E0001
1111111111