1111111111111
1C010000000C1
100001111101
1P00110010001
100011E000C01
1111111111111
