1111111111111
1001000000001
1000011111001
1P00110010001
100011E000001
1111111111111
