1111111111111
1C010000000C1
1000011111001
1P0P110010001
100011E000C01
1111111111111