1111111111
1011111001
1P000EC001
1111111111